0,0,0,0,0,0,0,0,0,0,0,0,0,0,0,0,0,0,0,0,0,0,0,0,0,0,0,0,0,0,0,0,0,0,0,0,0,0,0,0,0,0,0,0,0,0,0,0,0,0,0,0,0,0,8,8,0,0,8,8,0,0,8,8,0,0,8,8,0,0,8,8,0,0,8,8,0,0,0,0,8,8,0,0,8,8,0,0,8,8,0,0,8,8,0,0,8,8,0,0,8,8,0,0,0,0,8,8,0,0,8,8,0,0,8,8,0,0,8,8,0,0,8,8,0,0,8,8,0,0,0,0,8,8,0,0,8,8,0,0,8,8,9,9,8,8,0,0,8,8,0,0,8,8,0,0,0,0,8,8,0,0,8,8,0,0,8,8,9,9,8,8,0,0,8,8,0,0,8,8,0,0,0,0,8,8,0,0,8,8,0,0,8,8,0,0,8,8,0,0,8,8,0,0,8,8,0,0,0,0,8,8,0,0,8,8,0,0,0,0,0,0,0,0,0,0,8,8,0,0,8,8,0,0,0,0,8,8,0,0,8,8,0,0,0,0,0,0,0,0,0,0,8,8,0,0,8,8,0,0,0,0,0,0,0,0,0,0,0,0,8,8,11,0,8,8,0,0,0,0,0,0,0,0,0,0,0,0,0,0,0,0,0,0,0,0,8,8,0,0,8,8,0,0,0,0,0,0,0,0,0,0,8,8,0,0,8,8,8,8,0,0,0,0,0,0,0,0,0,0,8,8,8,8,0,0,8,8,9,9,0,0,8,8,8,8,0,0,0,0,0,0,0,0,0,0,8,8,8,8,0,0,9,9,0,0,0,0,0,0,0,0,0,0,8,8,0,0,8,8,0,0,0,0,0,0,0,0,0,0,0,0,0,0,0,0,0,0,0,0,8,8,8,8,8,8,0,0,0,0,0,0,0,0,0,0,0,0,8,8,0,0,8,8,0,0,8,8,8,8,8,8,0,0,8,8,0,0,8,8,0,0,0,0,8,8,0,0,8,8,0,0,8,8,0,0,8,8,0,0,8,8,0,0,8,8,0,0,0,0,8,8,0,0,8,8,0,0,8,8,0,0,8,8,0,0,8,8,0,0,8,8,0,0,0,0,8,8,0,0,8,8,0,0,8,8,0,0,8,8,0,0,8,8,0,0,8,8,10,0,10,0,8,8,0,0,8,8,0,0,8,8,0,0,8,8,0,0,8,8,0,0,8,8,0,0,0,0,8,8,0,0,8,8,0,0,0,0,0,0,0,0,0,0,8,8,0,0,8,8,10,0,10,0,8,8,0,0,8,8,0,0,0,0,0,0,0,0,0,0,8,8,0,0,8,8,0,0,0,0,8,8,0,0,8,8,0,0,0,8,8,8,8,0,0,0,8,8,0,0,8,8,0,0,0,0,10,0,0,0,10,0,0,0,0,8,13,0,8,0,0,0,10,0,0,0,10,0,0,0,0,0,0,0,0,0,0,0,0,0,0,8,0,0,8,0,0,0,0,0,0,0,0,0,0,0
0,0,0,0,0,0,0,0,0,0,0,0,0,0,0,0,0,0,0,0,0,0,0,0,0,0,0,0,0,0,0,0,0,0,0,0,0,0,0,0,0,0,0,0,0,0,0,0,0,0,0,0,12,12,12,12,12,12,12,12,12,12,12,12,0,0,8,8,0,0,8,8,0,0,8,8,0,0,0,0,8,8,0,0,8,8,0,0,8,12,12,12,12,12,12,12,12,12,12,12,12,12,12,0,0,0,8,8,0,0,0,8,0,0,8,8,0,0,8,8,0,0,8,8,0,0,8,8,0,0,0,0,8,8,0,0,8,8,0,0,8,8,9,9,8,0,0,0,8,8,0,0,8,8,0,0,0,0,8,8,0,0,8,8,0,0,8,8,8,8,8,8,8,0,8,8,0,0,8,8,0,0,0,0,8,8,0,0,8,8,0,0,8,8,0,0,0,8,0,0,8,8,0,0,8,8,0,0,11,11,11,11,11,0,11,8,11,11,11,8,0,0,0,8,11,0,11,11,11,11,11,11,11,0,11,11,11,11,11,11,11,11,11,11,11,8,0,0,0,8,11,11,11,11,11,11,11,8,0,0,11,11,11,11,11,11,11,11,11,0,11,8,0,0,0,8,11,11,11,11,11,0,11,11,11,0,0,0,0,0,0,0,0,0,0,0,8,8,0,0,0,8,11,0,0,0,0,0,0,8,8,8,8,8,8,8,8,8,8,8,0,0,8,8,8,8,8,8,8,0,8,8,8,8,8,8,8,8,8,8,8,8,8,8,8,8,8,8,8,8,8,8,8,8,8,8,8,8,8,8,8,8,8,8,8,8,8,8,0,8,8,8,8,8,8,8,8,8,8,8,8,8,8,8,8,8,8,8,8,8,8,8,8,0,0,8,8,8,8,8,8,8,8,8,8,8,8,8,8,8,8,8,8,8,8,8,8,8,8,8,0,8,8,8,8,8,8,8,8,8,8,8,8,8,8,8,8,8,8,8,8,8,8,8,8,8,8,8,8,8,8,8,8,8,8,8,8,8,8,8,8,8,8,8,8,8,8,8,8,8,8,8,0,8,8,8,8,8,8,8,8,8,8,8,8,8,8,8,8,8,8,8,8,0,8,8,8,8,0,0,8,8,8,8,8,8,8,8,8,8,8,8,8,8,8,8,8,8,10,0,8,8,8,8,0,0,8,8,8,8,8,8,8,8,8,8,8,8,8,8,0,0,8,8,0,0,8,8,8,8,0,0,8,8,8,8,8,8,8,8,8,8,8,8,8,8,0,0,12,8,12,0,8,0,12,8,0,0,8,8,8,0,0,0,0,0,0,0,0,8,8,8,0,0,8,8,0,0,8,0,8,8,0,0,8,8,0,0,0,9,9,9,9,0,0,0,8,8,0,0,8,8,0,0,8,12,10,0,0,0,8,0,0,0,0,9,13,0,9,0,0,0,10,8,8,0,10,0,0,0,8,0,0,0,0,8,8,0,0,0,0,9,0,0,9,0,0,0,0,0,8,8,0,0,0,0
0,0,0,0,0,0,0,0,0,0,0,0,0,0,8,0,0,0,0,0,0,0,0,0,0,0,0,0,0,0,0,0,0,0,0,0,0,0,0,0,0,0,0,0,0,0,0,0,0,0,0,0,12,12,8,8,12,12,8,8,8,0,8,8,8,0,8,8,0,0,8,8,0,0,8,8,0,0,0,0,8,8,0,0,8,8,8,0,8,8,8,0,0,0,0,0,12,12,12,12,12,12,12,0,0,0,8,8,0,0,0,8,0,0,0,8,8,0,8,8,0,0,8,8,0,0,8,8,0,0,0,0,8,8,0,0,8,8,0,0,8,8,9,9,8,0,0,0,8,8,0,0,8,8,0,0,0,0,8,8,0,0,8,8,0,0,8,8,8,8,8,8,8,8,8,8,0,0,8,8,0,0,0,0,8,8,0,0,8,8,0,0,8,8,0,0,0,8,8,8,8,8,0,0,8,8,0,0,11,11,11,11,11,0,11,11,11,11,9,9,8,8,8,8,9,9,11,11,11,11,11,11,11,0,11,11,11,11,11,11,11,11,11,11,9,8,8,8,8,8,8,9,11,11,11,11,11,11,11,0,11,11,11,11,11,11,11,11,11,11,9,9,8,8,8,8,9,9,11,11,11,11,11,11,11,0,11,0,11,11,11,11,11,11,11,11,9,9,8,8,8,8,9,9,11,11,11,11,11,11,11,8,8,8,8,8,8,8,8,8,0,0,9,9,8,8,8,8,9,9,8,8,0,0,0,0,11,8,8,8,8,8,8,10,10,10,0,10,10,0,0,0,0,0,0,0,0,0,0,10,10,8,0,0,8,8,8,8,0,0,0,0,0,0,0,0,8,8,8,8,0,0,0,0,0,10,9,8,8,8,8,8,8,9,0,10,10,10,0,8,8,8,8,8,8,8,8,10,0,0,9,9,9,9,9,0,8,9,9,9,9,9,8,8,0,10,10,10,8,8,8,8,8,10,0,0,0,10,9,10,0,0,8,8,8,9,0,10,10,10,10,0,10,10,8,8,8,8,8,8,8,8,0,10,9,8,0,0,8,8,8,9,0,0,8,8,0,0,8,8,8,8,8,8,8,8,10,10,0,9,8,9,0,0,8,8,9,8,9,0,8,8,0,10,8,8,8,8,8,8,8,8,8,8,0,0,8,8,0,0,8,8,8,8,0,0,8,8,8,10,10,8,8,8,8,8,8,8,8,8,0,0,8,8,0,0,8,8,8,8,0,0,8,8,8,8,8,8,8,8,8,8,8,8,8,8,0,0,12,8,12,0,8,0,0,8,0,0,8,8,8,0,0,0,0,0,0,0,0,8,8,8,0,0,8,8,0,0,8,0,8,8,0,0,8,10,0,10,0,9,9,9,9,10,10,8,8,8,0,0,8,8,0,0,8,12,0,0,0,0,8,0,0,0,0,8,13,0,8,0,0,8,8,8,8,0,10,0,0,0,8,0,0,0,0,8,8,0,0,0,0,9,0,0,9,10,0,0,0,0,8,8,0,0,0,0
0,0,0,0,0,0,0,0,0,0,8,0,0,0,8,0,0,0,0,0,0,0,0,0,0,0,0,0,0,0,0,8,8,8,8,8,8,0,0,0,0,0,0,0,0,0,0,0,0,0,0,0,12,12,12,12,12,8,8,0,0,8,8,12,0,0,8,8,0,0,8,8,0,0,8,8,0,0,0,0,8,8,8,8,8,8,8,8,8,12,0,0,0,0,0,0,12,12,12,12,12,12,12,0,0,0,8,8,8,8,8,8,8,8,8,0,0,0,8,8,0,0,8,8,0,0,8,8,0,0,0,0,8,8,8,8,8,8,8,8,8,8,9,9,8,0,0,0,8,8,0,0,8,8,0,0,0,0,8,8,0,0,8,8,8,0,0,0,8,8,8,8,0,0,8,8,0,0,8,8,0,0,0,0,8,8,0,0,8,8,0,0,0,0,0,0,0,0,0,0,8,8,0,0,8,8,0,0,11,11,11,11,11,8,8,8,8,8,8,8,8,8,8,8,8,8,8,8,8,11,11,11,11,0,11,11,11,11,11,8,8,8,8,8,8,8,8,8,8,8,8,8,8,8,8,11,11,11,11,0,11,11,11,11,9,9,11,11,11,11,0,0,11,9,8,8,8,8,9,11,11,11,11,11,11,0,11,0,11,11,11,11,11,11,11,11,0,0,0,9,8,8,8,8,9,11,11,11,8,8,8,8,11,11,11,11,11,11,11,11,11,11,0,11,11,9,8,8,8,8,9,11,11,11,8,8,8,8,11,11,11,11,0,0,0,0,0,0,11,11,11,9,8,8,8,8,9,11,11,11,8,8,8,8,11,11,11,11,0,0,0,0,0,0,11,11,8,9,8,8,8,8,9,0,0,8,8,8,8,8,11,11,11,11,0,0,0,0,0,0,11,11,11,9,8,8,8,8,9,11,11,8,8,8,8,8,0,0,0,0,0,0,8,8,0,0,0,0,8,9,8,8,8,8,9,8,8,8,8,8,8,8,8,8,8,0,0,0,0,0,0,0,0,0,8,9,8,8,8,8,9,8,8,8,8,8,8,8,8,8,8,0,0,0,0,0,0,0,8,8,0,9,8,8,8,8,9,8,8,8,8,0,8,8,8,8,0,0,0,0,8,8,0,0,0,0,0,8,0,0,8,8,8,8,8,8,8,0,8,8,8,0,0,0,0,0,0,8,8,0,0,0,0,0,0,8,8,8,8,8,0,8,0,0,8,8,8,9,9,9,8,0,0,0,8,8,8,8,0,8,8,8,8,8,8,8,0,8,0,0,8,8,8,9,9,9,8,0,8,0,8,0,0,0,0,0,0,0,0,0,8,0,0,8,0,0,0,8,8,9,9,9,8,0,8,0,0,0,0,9,9,9,9,0,0,0,8,0,0,8,0,0,0,8,8,0,10,10,8,0,0,0,0,0,0,9,13,0,9,0,0,0,0,0,8,8,0,0,0,8,0,0,0,0,10,0,0,0,0,0,0,9,0,0,9,0,0,0,0,0,8,8,0,0,0,0
0,0,0,0,0,0,0,0,0,10,0,0,0,0,0,0,0,8,0,0,0,0,10,10,10,10,0,0,10,8,0,0,0,0,0,10,0,0,0,0,0,0,8,8,0,0,0,0,10,10,10,0,0,0,8,8,0,0,0,0,0,8,8,8,0,0,0,0,8,0,0,0,0,0,0,10,10,10,8,8,8,0,0,0,0,0,0,0,0,8,8,8,8,8,8,0,0,0,0,0,0,0,0,0,0,0,0,0,0,0,0,0,0,0,0,0,0,0,0,0,0,0,0,0,0,0,0,0,0,0,0,0,0,0,0,0,0,0,0,0,0,0,0,0,0,0,0,0,0,0,0,0,0,0,0,0,0,0,0,0,0,0,0,0,0,0,0,0,0,0,0,0,0,0,0,0,0,0,0,0,0,0,0,0,0,0,0,0,0,0,0,0,0,0,0,0,0,0,0,0,0,0,0,0,0,0,0,0,11,11,11,11,11,11,11,11,11,11,8,8,8,8,8,8,8,11,11,11,11,11,11,11,11,11,0,0,0,0,0,0,0,0,0,0,8,8,8,8,8,8,8,0,0,0,0,0,0,0,0,0,10,0,0,0,0,0,0,0,0,0,0,8,8,8,8,8,0,0,0,0,0,0,0,0,0,10,0,0,0,0,0,0,0,0,0,0,0,0,0,0,0,0,0,0,0,0,0,0,0,0,0,0,0,0,0,0,0,0,0,0,0,0,0,0,0,0,0,0,0,0,0,0,0,0,0,0,0,0,0,0,0,0,0,8,0,0,0,0,0,0,0,0,0,0,0,0,0,0,8,0,0,0,0,0,0,0,0,8,0,8,0,8,0,0,0,0,0,0,0,0,0,0,8,0,8,0,8,0,0,0,0,0,0,8,8,8,8,8,0,0,0,0,0,0,0,0,0,0,8,8,8,8,8,0,0,0,0,0,0,8,8,8,8,8,0,0,0,0,0,0,0,0,0,0,8,8,8,8,8,0,0,0,0,0,0,8,8,8,8,8,0,0,0,0,0,0,0,0,0,0,8,8,8,8,8,0,0,0,0,0,0,8,0,0,0,8,0,0,0,0,0,0,0,0,0,0,8,0,0,0,8,0,0,0,0,0,0,0,0,0,0,0,0,0,0,0,0,8,0,0,0,0,0,0,0,0,0,0,0,0,0,0,0,0,0,0,0,0,0,0,0,0,0,8,0,0,0,0,0,0,0,0,0,0,0,0,0,0,0,0,0,0,0,8,8,12,8,8,0,8,0,8,12,8,8,0,0,0,0,0,0,0,0,0,0,0,0,0,8,8,0,0,0,8,8,8,8,8,0,0,8,8,0,0,0,0,0,0,0,0,0,0,0,0,8,0,0,0,0,9,9,9,9,0,0,0,0,8,8,0,0,0,0,0,0,0,0,0,0,12,8,0,0,0,0,8,13,0,8,0,0,0,0,0,12,0,0,0,0,0,0,0,0,0,0,8,0,0,0,0,0,9,0,0,9,0,0,0,0,0,8,8,0,0,0,0
0,0,0,0,0,0,0,0,0,0,0,0,0,0,0,0,0,0,0,0,0,0,0,0,0,0,8,8,0,0,0,0,0,0,0,0,0,0,8,8,0,0,0,0,0,0,0,0,0,0,8,8,0,0,0,0,0,0,0,8,0,0,0,0,0,8,0,0,0,0,0,0,0,0,0,0,0,0,0,0,0,0,0,0,8,8,0,0,0,0,0,8,0,0,0,0,0,0,0,0,0,0,0,0,0,0,11,11,11,11,8,8,0,0,0,0,0,8,8,8,11,0,0,0,0,0,0,0,0,0,11,11,11,0,0,0,8,8,8,8,8,8,8,8,8,8,11,11,11,11,11,11,11,0,0,0,0,0,0,0,0,0,0,0,0,8,8,8,8,8,0,0,0,0,0,0,0,0,11,11,11,0,0,0,0,0,0,0,0,0,0,0,8,8,8,8,0,0,0,0,0,0,0,0,0,0,0,0,0,0,0,0,0,0,0,0,0,0,8,0,0,8,0,0,0,0,0,0,0,0,0,0,0,0,0,0,0,0,0,0,0,0,0,0,8,0,0,8,0,0,0,0,0,0,0,0,0,0,0,0,0,0,0,0,0,0,0,0,0,0,8,0,0,8,0,0,0,0,0,0,0,0,0,0,0,0,0,0,0,0,0,0,0,0,0,0,0,9,9,0,0,0,0,0,0,0,0,0,8,8,8,0,0,0,0,0,0,0,0,0,8,0,0,0,0,0,0,0,0,0,0,0,0,8,8,0,8,8,0,0,0,8,8,0,0,0,8,0,8,8,0,0,8,8,8,8,0,0,0,8,0,8,0,8,0,0,8,8,8,8,0,0,8,8,8,0,0,0,8,0,0,8,8,0,0,0,8,8,0,8,0,0,8,0,8,8,0,0,8,8,8,8,0,0,8,0,8,8,8,0,0,0,0,0,0,0,0,0,8,8,8,0,0,0,8,0,0,8,0,0,8,8,8,0,8,8,8,0,8,0,0,8,0,0,0,0,0,0,0,0,0,0,0,0,0,0,0,0,0,0,0,0,0,0,8,0,0,8,0,0,0,0,0,0,0,0,0,0,0,0,0,0,0,0,0,0,0,0,0,0,0,0,0,0,0,0,0,0,0,0,0,0,0,0,0,0,0,0,0,0,0,0,0,0,0,0,0,0,0,0,0,0,0,0,0,0,0,0,0,0,0,0,0,0,0,0,0,0,0,0,0,0,0,0,0,0,0,0,0,0,0,0,0,0,12,12,12,0,0,12,12,12,12,12,12,0,0,0,0,0,0,0,0,0,0,0,0,0,0,0,12,0,12,12,0,0,0,0,0,0,12,0,0,0,0,0,0,0,0,0,0,0,0,0,12,12,12,0,0,9,9,9,9,0,0,0,12,0,0,0,0,0,0,0,0,0,0,0,0,0,12,0,0,0,0,9,13,0,9,0,0,0,12,0,0,0,0,0,0,0,0,0,0,0,0,0,0,0,0,0,0,9,0,0,9,0,0,0,0,0,0,0,0,0,0,0
0,0,0,0,0,0,0,0,0,0,0,0,0,0,0,0,0,0,0,0,0,0,0,0,0,0,0,0,0,0,0,0,0,0,0,0,0,0,0,0,0,0,0,0,0,0,0,0,0,0,0,0,0,0,0,0,0,0,0,0,0,0,0,0,0,0,0,0,0,0,0,0,0,0,0,0,0,0,0,0,0,0,0,0,0,0,0,0,0,8,8,8,8,8,0,0,0,0,0,0,0,0,0,0,11,11,11,0,11,11,0,11,11,11,0,8,8,0,8,8,11,11,11,11,11,11,0,11,11,11,0,0,11,11,11,11,11,11,0,11,0,8,8,8,8,8,11,11,11,11,11,11,11,11,0,0,0,0,0,0,0,0,0,0,0,0,0,0,8,8,8,0,0,0,0,0,0,0,0,0,0,0,0,0,0,0,0,0,0,0,8,0,0,0,8,8,8,0,0,0,8,0,0,0,0,0,0,0,0,0,0,0,0,0,0,0,8,8,8,8,8,8,8,8,8,8,8,0,0,0,10,0,0,0,0,0,0,0,10,0,0,0,0,8,8,0,0,0,0,8,8,0,0,0,0,0,0,0,0,0,0,0,0,0,0,0,0,0,8,8,8,0,0,0,0,8,8,8,0,0,0,0,0,0,0,0,0,0,0,0,0,0,0,0,0,0,0,0,0,0,0,0,0,0,0,0,0,0,0,0,0,0,0,0,0,0,0,0,0,0,0,0,0,0,0,0,0,0,0,0,0,0,0,0,0,0,0,0,0,0,8,8,8,8,8,0,0,0,0,0,0,0,0,0,0,0,0,8,0,0,0,8,0,0,0,8,8,0,0,8,8,0,0,0,8,0,0,0,8,0,0,0,0,8,0,0,0,8,0,0,0,8,0,0,0,8,0,0,0,0,8,0,0,0,8,0,0,0,0,8,0,0,8,8,0,0,0,8,0,0,0,0,0,0,0,0,8,8,8,8,8,0,0,0,0,8,0,8,8,0,0,0,8,8,0,0,8,8,0,0,0,0,8,0,0,0,8,0,0,0,0,8,8,8,0,0,0,0,8,8,0,8,8,0,0,0,0,0,8,0,0,0,8,0,0,0,0,8,8,8,0,0,0,0,0,8,8,8,0,0,0,0,0,0,0,0,0,0,0,0,0,0,0,8,0,8,8,8,8,0,0,0,0,0,0,0,0,0,0,0,0,0,0,0,0,0,0,0,0,8,0,0,0,0,0,0,0,0,0,0,0,0,0,0,0,0,0,0,0,0,0,0,0,0,0,0,0,0,0,0,0,0,0,0,0,0,0,0,0,0,0,0,0,0,0,0,0,0,0,0,0,0,0,0,0,0,0,0,0,0,0,0,0,0,0,12,0,0,0,9,9,9,9,0,0,0,0,12,0,0,0,0,0,0,0,0,0,0,0,0,0,0,0,0,0,9,13,0,9,0,0,0,0,0,0,0,0,0,0,0,0,0,0,0,0,0,0,0,0,0,0,9,0,0,9,0,0,0,0,0,0,0,0,0,0,0
0,0,0,0,0,0,0,0,0,0,0,0,0,0,0,0,0,0,0,0,0,0,0,0,0,0,0,0,0,0,0,0,0,0,0,0,0,0,0,0,0,0,0,0,0,0,0,0,0,0,0,0,0,0,0,0,0,0,0,0,0,0,8,8,0,0,0,0,0,0,0,0,0,0,0,0,0,0,0,0,0,0,0,0,0,0,0,8,8,8,8,0,0,0,0,0,0,0,0,0,0,0,0,0,0,0,0,0,0,0,8,0,8,0,10,0,0,8,0,8,0,0,0,0,0,0,0,0,0,0,0,0,0,0,0,8,8,0,8,0,11,11,0,8,0,8,8,0,0,0,0,0,0,0,0,0,0,0,0,0,8,0,8,0,0,8,8,8,8,0,0,8,0,8,0,0,0,0,0,0,0,0,0,0,0,0,8,8,8,8,8,8,0,0,8,8,8,8,8,8,0,0,0,0,0,0,0,0,0,0,0,0,0,0,0,8,0,0,0,0,0,0,8,0,0,0,0,0,0,0,0,0,0,0,0,0,0,8,8,8,8,8,8,0,0,0,0,8,8,8,8,8,8,0,0,0,0,0,0,0,0,0,0,8,0,0,8,0,8,8,0,0,8,8,0,8,0,0,8,0,0,0,0,0,0,0,0,0,0,8,0,0,8,0,0,8,8,8,8,0,0,8,0,0,8,0,0,0,0,0,0,0,0,0,0,8,0,0,8,0,8,8,8,8,8,8,0,8,0,0,8,0,0,0,0,0,0,0,0,0,0,8,0,8,0,0,8,8,0,0,8,8,0,0,8,0,8,0,0,0,0,0,0,0,0,0,0,0,8,0,0,0,8,8,0,0,8,8,0,0,0,8,0,0,0,0,0,0,0,0,0,0,0,0,0,0,0,0,8,8,0,0,8,8,0,0,0,0,0,0,0,0,0,0,0,0,0,0,0,0,0,0,0,8,8,8,0,0,8,8,8,0,0,0,0,0,0,0,0,0,0,0,0,0,0,0,0,0,8,8,8,8,0,0,8,8,8,8,0,0,0,0,0,0,0,0,0,0,0,0,0,0,0,0,0,0,0,0,0,0,0,0,0,0,0,0,0,0,0,0,0,0,0,0,0,0,0,0,0,0,0,0,0,0,0,0,0,0,0,0,0,0,0,0,0,0,0,0,0,0,0,0,0,0,0,0,0,0,0,0,0,0,0,0,0,0,0,0,0,0,0,0,0,0,0,0,0,0,0,0,0,0,0,0,0,0,0,0,0,0,0,0,0,0,0,0,0,0,0,0,0,0,0,0,0,0,0,0,0,0,0,0,0,0,0,0,0,0,0,0,0,0,0,0,0,0,0,0,0,0,0,0,0,0,0,0,0,0,0,9,9,9,9,0,0,0,0,0,0,0,0,0,0,0,0,0,0,0,0,0,0,0,0,0,0,9,13,0,9,0,0,0,0,0,0,0,0,0,0,0,0,0,0,0,0,0,0,0,0,0,0,9,0,0,9,0,0,0,0,0,0,0,0,0,0,0
0,0,0,0,0,0,0,0,0,0,0,0,0,0,0,0,0,0,0,0,0,0,0,0,0,0,0,0,0,0,0,0,0,0,0,0,0,0,0,0,0,0,0,0,0,0,0,0,0,0,0,0,12,12,12,12,12,12,12,12,12,12,12,12,0,0,8,8,0,0,8,8,0,0,8,8,0,0,0,0,8,8,0,0,8,8,0,0,8,12,12,12,12,12,12,12,12,12,12,12,12,12,12,0,0,0,8,8,0,0,0,8,0,0,8,8,0,0,8,8,0,0,8,8,0,0,8,8,0,0,0,0,8,8,0,0,8,8,0,0,8,8,9,9,8,0,0,0,8,8,0,0,8,8,0,0,0,0,8,8,0,0,8,8,0,0,8,8,8,8,8,8,8,0,8,8,0,0,8,8,0,0,0,0,8,8,0,0,8,8,0,0,8,8,0,0,0,8,0,0,8,8,0,0,8,8,0,0,11,11,11,11,11,0,11,8,11,11,11,8,0,0,0,8,11,0,11,11,11,11,11,11,11,0,11,11,11,11,11,11,11,11,11,11,11,8,0,0,0,8,11,11,11,11,11,11,11,8,0,0,11,11,11,11,11,11,11,11,11,0,11,8,0,0,0,8,11,11,11,11,11,0,11,11,11,0,0,0,0,0,0,0,0,0,0,0,8,8,0,0,0,8,11,0,0,0,0,0,0,8,8,8,8,8,8,8,8,8,8,8,8,8,8,8,8,8,8,8,8,8,8,8,8,8,8,8,8,8,8,8,8,8,8,8,8,8,8,8,8,8,8,8,8,8,8,8,8,8,8,8,8,8,8,8,8,8,8,8,8,8,8,8,8,8,8,8,8,8,8,8,8,8,8,8,8,8,8,8,8,8,8,8,8,0,0,0,0,0,0,0,0,0,0,0,0,0,0,0,0,0,0,0,0,0,0,0,8,8,8,0,0,0,0,0,0,0,0,0,0,0,0,0,0,0,0,0,0,0,0,0,0,0,8,8,8,8,0,0,0,0,0,0,0,0,0,0,0,0,0,0,0,0,0,0,0,8,0,0,8,8,8,8,0,0,0,0,0,0,0,0,0,0,0,0,0,0,0,0,0,0,8,0,0,0,8,8,8,8,0,0,8,8,8,8,8,8,8,8,8,8,8,8,8,8,0,0,8,8,0,0,8,8,8,8,0,0,8,8,8,8,8,8,8,8,8,8,8,8,8,8,0,0,8,8,0,0,8,8,8,8,0,8,8,8,8,8,8,8,8,8,8,8,8,8,8,8,0,0,12,8,12,0,8,0,12,8,0,0,8,8,8,0,0,0,0,0,0,0,0,8,8,8,0,0,8,8,0,0,8,0,8,8,0,0,8,8,0,0,0,9,9,9,9,0,0,0,8,8,0,0,8,8,0,0,8,12,10,0,0,0,8,0,0,0,0,9,13,0,9,0,0,0,10,8,8,0,10,0,0,0,8,0,0,0,0,8,8,0,0,0,0,9,0,0,9,0,0,0,0,0,8,8,0,0,0,0
0,0,0,0,0,0,0,0,0,0,0,0,0,0,0,0,0,0,0,0,0,0,0,0,0,0,0,0,0,0,0,0,0,8,0,0,0,0,0,0,0,0,0,8,0,0,0,0,0,0,0,0,0,0,0,0,0,0,8,8,8,8,0,0,0,0,0,0,8,8,8,0,0,0,0,0,0,0,0,0,0,0,0,8,8,8,8,0,0,0,0,0,0,8,8,0,8,8,0,0,8,0,0,0,0,0,0,0,0,0,0,8,0,0,0,0,0,0,8,8,0,0,0,8,8,0,0,8,8,0,0,0,0,0,0,0,0,8,8,8,0,0,0,0,0,0,0,0,0,0,0,8,8,8,0,8,0,0,0,0,0,0,0,0,0,8,8,8,0,0,0,0,0,0,0,0,0,0,8,8,8,8,0,0,0,0,0,0,0,0,0,0,0,0,0,0,0,0,0,0,0,0,0,0,0,8,0,8,10,10,11,10,11,10,11,10,11,10,11,10,12,12,10,11,10,10,10,11,10,10,10,11,10,10,0,0,0,0,0,0,0,0,0,0,0,0,0,0,0,0,0,0,0,0,0,0,0,0,0,0,0,0,0,0,0,0,0,0,0,0,0,0,0,0,0,0,0,0,0,0,0,0,0,0,0,0,0,0,0,0,0,0,0,0,0,0,0,0,0,0,0,0,0,0,0,0,0,0,0,0,0,0,0,0,0,0,0,0,0,0,0,0,0,0,0,0,0,0,0,0,0,0,0,0,0,0,0,0,0,0,0,0,0,0,0,0,0,0,0,0,0,0,0,0,8,8,0,0,0,0,0,0,0,0,0,0,0,8,0,0,0,0,0,0,8,0,0,0,0,0,0,8,8,0,8,8,8,8,8,0,0,0,8,8,0,0,0,0,8,8,8,8,8,0,0,8,8,8,8,8,0,0,8,0,8,0,0,0,8,0,8,0,0,0,0,0,0,8,0,0,0,0,0,0,8,8,0,8,8,0,8,0,0,8,8,0,0,8,0,0,8,0,8,0,0,0,0,8,8,8,0,0,0,8,0,8,8,0,0,0,0,0,0,0,0,0,0,8,8,8,0,0,8,8,0,8,8,8,0,8,0,8,0,0,0,0,0,0,0,0,0,0,0,0,0,0,8,0,0,0,0,8,0,0,8,8,0,8,0,0,0,0,0,0,0,0,0,0,0,0,0,0,0,0,0,0,0,8,8,0,0,8,0,8,0,0,0,0,0,0,0,0,0,8,0,8,8,0,0,0,0,0,8,8,8,0,8,8,8,8,0,0,0,0,0,0,0,0,0,0,0,0,0,12,0,12,12,0,0,8,0,8,8,0,0,8,0,0,0,0,0,0,0,0,0,8,0,0,0,9,9,9,9,0,0,0,0,8,0,0,0,0,0,0,0,0,0,0,0,0,0,0,0,0,0,9,13,0,9,0,0,0,8,0,0,0,0,0,0,0,0,0,0,0,0,0,0,8,0,0,0,9,0,0,9,0,0,0,0,0,0,0,0,0,0,0
0,0,0,0,0,0,0,0,8,8,0,0,0,0,0,0,0,0,8,8,0,0,0,0,0,0,0,0,0,0,0,0,0,0,8,8,0,0,0,0,0,0,0,0,8,8,0,0,0,0,0,0,0,0,10,0,10,0,0,0,8,8,0,0,0,0,0,0,0,0,0,0,0,0,0,0,0,0,0,0,0,0,0,0,0,0,0,0,0,0,0,0,0,0,0,0,0,0,0,0,0,0,0,0,8,8,10,0,10,0,0,0,0,0,0,0,0,8,8,8,0,0,0,9,9,9,9,9,9,9,8,8,0,0,0,0,0,0,0,0,0,0,0,8,8,8,0,0,0,9,9,9,9,9,9,9,0,0,10,0,10,0,0,0,0,0,0,0,0,8,8,8,0,0,0,0,0,0,0,0,0,0,0,0,0,0,0,0,0,0,8,8,8,8,8,8,8,8,8,8,8,0,0,0,0,0,0,0,10,0,10,0,10,0,0,0,8,8,8,8,8,8,8,8,8,8,8,0,0,8,8,8,8,8,0,0,0,0,0,0,0,0,8,8,8,8,8,8,8,8,8,8,8,0,0,8,8,8,8,8,0,0,0,0,0,0,0,0,0,0,0,0,0,0,0,0,0,0,0,0,8,8,0,0,8,0,0,0,0,0,0,0,0,0,0,0,0,0,0,0,0,0,0,0,0,0,8,8,0,0,8,0,0,0,0,0,8,8,0,0,0,9,9,9,9,9,9,9,9,9,0,0,8,8,0,0,8,0,0,0,0,0,8,0,0,0,0,9,9,9,9,9,9,9,9,9,0,0,0,0,0,0,8,0,8,8,8,8,8,0,0,0,0,0,0,0,0,0,0,0,0,0,0,0,0,0,0,0,0,0,8,8,8,8,8,0,0,0,0,8,8,0,0,0,0,8,8,8,8,8,8,8,8,8,8,0,8,8,8,8,8,0,0,8,8,8,8,8,0,0,8,8,0,0,0,0,0,0,0,0,0,0,8,8,8,8,8,0,0,8,8,8,8,8,0,0,8,8,0,0,8,8,8,8,8,8,0,0,0,0,0,0,0,0,0,0,0,0,0,8,8,8,8,8,0,0,8,8,8,8,8,8,0,0,0,0,0,0,0,0,9,0,0,0,0,8,8,8,8,8,0,0,0,0,0,0,0,0,0,0,8,8,8,0,0,0,9,0,0,0,0,0,0,0,0,0,0,0,8,8,8,8,8,8,8,0,8,8,8,0,0,0,9,0,0,0,0,0,0,0,0,0,0,0,8,8,8,8,8,8,8,0,8,8,8,0,0,0,9,0,0,0,0,0,0,0,0,0,0,0,0,0,0,10,0,10,0,0,8,8,8,8,8,8,0,0,0,0,0,8,8,8,8,0,0,0,0,0,0,0,0,0,0,0,8,8,8,8,8,8,0,0,0,0,0,8,13,0,8,0,0,0,8,8,8,10,0,10,0,0,8,8,8,8,8,8,0,0,0,0,0,8,0,0,8,0,0,0,8,8,8,8,0,0,0,0
0,0,10,0,10,0,0,0,0,0,0,0,0,0,0,0,0,0,0,0,0,0,10,0,0,0,0,0,0,0,0,0,0,0,0,0,0,0,0,0,0,0,0,0,0,0,0,0,0,0,0,0,10,0,10,0,0,0,0,0,8,8,8,0,0,0,0,0,0,0,0,0,0,0,0,0,10,0,0,0,0,0,0,0,8,8,8,8,8,8,8,8,8,8,8,8,8,8,0,0,0,0,0,0,10,0,0,0,0,8,8,8,8,8,8,8,8,8,8,8,8,8,8,8,8,8,0,0,9,9,0,0,0,0,0,8,8,8,8,8,8,8,8,8,8,8,8,8,8,8,8,8,0,0,0,0,0,0,0,0,0,8,8,8,8,8,8,8,8,8,8,8,8,8,8,8,8,8,8,8,0,0,0,0,0,0,8,8,8,8,8,8,8,8,8,8,8,8,8,8,8,0,0,0,8,8,0,0,0,0,0,0,8,8,8,8,8,8,8,8,8,8,8,8,8,8,8,0,0,0,8,8,0,0,0,0,0,0,8,8,8,8,8,0,0,0,0,0,0,0,0,8,8,8,8,0,8,8,0,0,0,0,0,8,8,8,8,0,0,0,0,0,0,0,0,0,0,8,8,8,8,0,0,8,0,0,0,0,0,8,8,8,0,0,9,0,0,0,9,0,0,0,0,0,8,8,8,0,0,0,0,0,11,0,0,8,8,0,0,0,9,0,0,0,9,0,0,0,0,0,8,8,8,0,11,0,11,0,0,0,0,8,8,0,0,0,9,0,0,0,9,0,0,0,0,0,8,8,8,0,0,0,0,0,0,0,8,8,8,8,0,0,0,0,0,0,0,0,0,0,0,0,8,8,8,0,0,0,0,0,0,0,8,8,8,0,0,0,0,0,0,0,0,0,0,0,0,0,8,8,8,0,0,0,0,0,0,0,8,8,8,0,0,0,8,8,8,8,0,0,0,0,0,0,8,8,8,0,0,0,0,0,0,0,8,8,8,8,8,8,8,8,8,8,8,8,8,8,8,8,8,8,8,0,0,0,0,0,0,0,8,8,8,8,8,8,8,8,8,8,8,8,8,8,8,8,8,8,8,8,0,0,0,0,0,0,8,8,8,8,8,8,8,8,8,8,8,8,8,8,8,8,8,8,8,8,0,0,0,0,0,0,8,8,8,8,8,8,8,8,8,8,8,8,8,8,8,8,8,8,8,8,0,0,10,0,0,0,0,0,8,8,8,8,8,0,0,0,0,0,0,0,0,0,0,8,8,8,8,8,0,0,10,0,8,0,0,0,0,8,8,8,8,0,0,0,0,0,0,0,8,8,8,8,8,8,10,0,0,0,8,8,8,8,0,0,0,0,0,8,8,8,8,0,0,0,0,0,0,0,0,0,0,0,9,9,10,0,0,0,0,0,0,0,0,8,13,0,8,0,0,0,0,0,0,0,10,0,9,9,9,9,10,0,0,0,0,0,0,0,0,8,0,0,8,0,0,0,0,0,0,0,0,0,9,9
0,0,0,0,0,0,9,9,0,0,0,0,0,0,9,9,0,0,0,0,0,0,0,0,0,0,0,0,0,0,0,0,9,9,0,0,0,0,0,0,9,9,0,0,0,0,0,0,0,0,0,0,0,0,8,8,0,0,9,9,0,0,0,0,0,0,8,8,0,0,8,8,0,0,8,8,0,0,0,0,8,8,0,0,9,9,0,0,0,0,0,0,8,8,0,0,8,8,0,0,8,8,0,0,0,0,8,8,0,0,0,0,0,0,0,0,8,8,8,8,0,0,8,8,9,9,8,8,0,0,0,0,8,8,0,0,0,0,0,0,0,0,8,8,8,8,0,0,8,8,9,9,8,8,0,0,0,0,0,0,0,0,8,8,0,0,0,0,0,0,0,0,0,0,9,9,0,0,0,0,0,0,0,0,0,0,0,0,8,8,0,0,0,0,0,0,0,0,0,0,9,9,0,0,0,0,0,0,10,0,0,0,0,0,8,8,0,0,0,0,9,9,0,0,0,0,8,8,10,0,8,8,9,9,0,0,0,0,0,0,8,8,0,0,0,0,9,9,0,0,0,0,8,8,0,0,8,8,9,9,10,0,10,0,0,0,0,0,0,0,8,8,0,0,0,0,9,9,0,0,10,0,0,0,0,0,0,0,0,0,0,0,0,0,0,0,8,8,0,0,0,0,9,9,0,0,0,0,0,0,0,0,0,0,8,8,8,8,8,8,10,0,10,0,10,0,9,9,0,0,0,0,10,0,8,8,0,0,0,0,8,8,8,8,8,8,0,0,0,0,0,0,9,9,0,0,0,0,0,0,8,8,0,0,0,0,0,0,0,0,9,9,10,0,8,8,0,0,8,8,0,0,8,8,0,0,8,8,0,0,0,0,0,0,0,0,9,9,0,0,8,8,0,0,8,8,0,0,8,8,0,0,8,8,0,0,9,9,8,8,0,0,9,9,0,0,8,8,0,0,8,8,0,0,0,0,0,0,8,8,0,0,9,9,8,8,0,0,9,9,0,0,8,8,0,0,8,8,0,0,0,0,0,0,8,8,0,0,0,0,8,8,0,0,8,8,0,0,8,8,8,8,8,8,0,0,8,8,9,9,8,8,0,0,0,0,8,8,0,0,8,8,0,0,8,8,8,8,8,8,0,0,8,8,9,9,8,8,0,0,0,0,8,8,0,0,8,8,0,0,8,8,8,8,8,8,0,0,0,0,0,0,0,0,0,0,0,0,8,8,0,0,8,8,0,0,8,8,8,8,8,8,0,0,0,0,0,0,0,0,0,0,0,0,8,8,0,0,0,0,0,0,0,0,0,0,0,0,0,0,8,8,0,0,8,8,0,0,0,0,8,8,0,0,0,0,0,0,0,8,8,8,8,0,0,0,8,8,0,0,8,8,0,0,0,0,8,8,0,0,8,8,0,0,0,8,13,0,8,0,0,0,8,8,8,8,8,8,0,0,0,0,8,8,0,0,8,8,0,0,0,8,0,0,8,0,0,0,8,8,8,8,8,8,0,0
0,0,12,0,12,0,12,0,12,0,12,0,0,0,12,0,12,0,12,0,12,12,12,0,0,0,0,0,0,0,0,0,0,0,0,0,0,0,0,0,0,0,0,0,0,0,0,8,0,0,0,0,12,0,12,0,0,0,8,8,8,8,8,8,0,0,8,8,8,8,8,8,8,8,0,0,12,0,0,0,0,0,0,0,8,8,8,8,8,8,0,0,8,8,8,8,8,8,8,8,0,0,0,0,12,0,12,0,0,0,8,8,0,0,8,8,0,0,8,8,8,0,0,8,8,8,0,0,12,0,0,0,0,0,0,0,8,8,0,0,8,8,0,0,8,8,8,0,0,8,8,8,0,0,0,0,12,0,12,0,0,0,8,8,8,8,8,8,0,0,8,8,8,0,0,8,8,8,0,0,12,0,0,0,0,0,0,0,8,8,8,8,8,8,0,0,8,8,8,0,0,8,8,8,0,0,0,0,12,0,12,0,0,0,0,0,0,0,8,8,0,0,8,8,8,0,0,8,8,8,0,0,12,0,0,0,0,0,0,0,0,0,0,0,8,8,0,0,8,8,8,0,0,8,8,8,0,0,0,0,12,0,12,0,0,0,8,8,8,8,8,8,0,0,8,8,8,8,8,8,8,8,0,0,12,0,0,0,0,0,0,0,8,8,8,8,8,8,0,0,8,8,8,8,8,8,8,8,0,0,0,0,12,12,0,12,0,12,0,12,0,12,0,12,0,12,0,12,0,12,0,12,12,12,12,0,12,0,0,0,0,0,0,0,0,0,0,0,0,0,0,0,0,0,0,0,0,0,0,0,0,0,0,0,9,9,0,0,0,0,0,0,0,0,0,0,9,9,0,0,0,0,0,0,0,0,0,0,9,9,9,9,0,0,0,0,0,0,0,0,0,0,9,9,0,0,0,0,0,0,0,0,0,0,9,9,10,0,0,0,0,0,0,0,0,0,8,8,8,8,8,8,0,0,0,0,0,0,0,0,10,0,0,0,0,0,0,0,0,0,0,0,8,8,8,8,8,8,0,0,0,0,0,0,0,0,0,0,10,0,8,8,0,0,8,8,0,0,8,8,8,8,8,8,0,0,8,8,0,0,8,8,10,0,0,0,8,8,9,9,8,8,9,9,8,8,8,8,8,8,9,9,8,8,9,9,8,8,0,0,10,0,8,8,9,9,8,8,9,9,8,8,0,0,8,8,9,9,8,8,9,9,8,8,10,0,0,0,8,8,0,0,8,8,0,0,0,0,0,0,0,0,0,0,8,8,0,0,8,8,0,0,10,0,8,8,0,0,8,8,0,0,0,0,0,0,0,0,0,0,8,8,0,0,8,8,10,0,0,0,8,8,0,0,8,8,0,0,0,8,8,8,8,0,0,0,8,8,0,0,8,8,0,0,10,0,10,0,0,0,0,0,0,0,0,8,13,0,8,0,0,0,0,0,0,0,10,0,10,0,0,0,0,0,0,0,0,0,0,0,0,8,0,0,8,0,0,0,0,0,0,0,0,0,0,0
0,0,0,0,8,8,0,0,0,0,0,0,0,0,0,0,0,0,0,0,0,8,8,0,0,0,0,0,0,0,8,8,0,0,0,0,0,0,0,0,0,0,0,0,0,0,0,8,8,0,0,0,0,0,0,0,8,8,0,0,8,8,8,0,0,0,0,0,0,8,8,8,0,8,8,0,0,0,0,0,0,0,8,8,0,8,8,9,8,8,8,8,8,8,8,8,9,8,8,8,8,8,8,8,8,8,8,8,8,8,0,0,0,0,0,0,8,8,0,0,0,0,0,0,0,8,8,8,8,8,8,8,8,8,8,8,0,0,0,8,0,8,0,8,8,0,8,0,0,0,0,0,0,0,0,0,0,0,0,0,0,0,0,0,0,0,8,8,8,8,0,8,0,0,0,0,0,0,0,0,0,0,0,0,0,0,0,0,0,0,0,0,8,8,0,8,8,8,0,0,0,0,0,0,0,0,0,0,0,0,0,0,0,0,0,0,0,0,0,0,0,0,0,0,0,0,0,0,0,0,0,0,0,0,0,0,0,0,0,0,0,0,0,0,0,8,10,10,8,0,0,0,0,0,0,0,0,0,0,0,11,11,12,0,11,11,0,12,11,0,0,0,0,0,0,0,11,12,11,0,11,11,12,11,11,11,0,0,0,0,0,11,11,11,0,0,8,0,8,8,0,8,0,0,0,0,0,0,0,0,0,0,0,0,0,0,0,0,0,0,0,0,8,8,8,8,8,8,0,0,0,0,0,0,0,0,0,0,9,9,0,0,0,0,0,0,0,0,0,10,10,0,10,0,0,0,0,0,0,0,0,0,0,0,0,9,9,9,0,0,0,0,0,0,0,8,0,0,8,0,0,0,0,0,0,0,0,0,0,9,0,0,0,9,9,0,0,0,0,0,0,10,10,10,8,0,0,0,0,0,0,0,9,9,9,9,0,0,0,0,9,0,0,0,0,0,0,8,10,0,8,0,0,0,0,9,9,9,9,0,0,0,0,0,0,0,0,0,0,0,0,0,8,8,0,0,8,8,0,0,0,0,0,0,0,0,0,0,0,0,0,0,0,0,0,0,0,0,8,0,8,8,0,8,0,0,0,0,0,0,0,0,0,0,10,10,10,10,10,0,0,0,0,0,0,0,8,8,0,0,0,0,0,10,0,10,0,10,0,10,0,0,0,0,0,0,0,0,0,0,0,0,0,0,0,0,0,0,0,0,0,10,0,0,0,10,10,0,10,10,0,10,0,0,0,0,0,0,0,0,0,0,0,0,10,10,10,0,0,10,0,10,0,0,0,0,0,0,0,0,0,0,0,0,0,0,0,0,0,0,0,10,0,0,10,0,0,10,10,0,10,0,10,0,0,0,0,0,0,9,9,9,9,0,0,0,0,10,0,10,0,10,0,10,10,10,0,0,0,0,0,0,0,0,0,9,13,0,9,0,0,0,0,0,0,0,0,0,10,10,0,0,10,0,10,0,0,0,0,0,0,9,0,0,9,0,0,0,0,10,0,10,10,10,10,10
0,0,0,0,0,0,0,0,0,0,0,0,0,0,0,0,0,0,0,0,0,0,0,0,0,0,0,0,0,0,0,0,0,0,0,0,0,0,0,0,0,0,0,0,0,0,0,0,0,0,0,0,0,0,0,0,0,0,0,0,0,0,9,9,0,0,9,9,9,0,0,0,0,0,0,0,0,0,0,0,0,0,0,0,0,0,0,9,9,9,9,9,9,0,9,0,0,0,0,0,0,0,0,0,0,0,0,0,0,0,0,0,0,9,9,0,8,0,8,9,9,0,0,0,0,0,9,9,9,9,9,9,9,9,0,0,0,0,0,0,9,0,0,0,0,9,0,0,0,0,0,0,9,0,0,0,0,0,0,9,0,0,0,0,0,0,9,9,0,0,9,9,0,0,0,0,0,0,9,0,0,0,0,0,0,9,0,0,0,0,0,0,0,0,9,9,9,0,0,0,0,0,0,0,9,0,0,0,0,0,0,9,0,0,0,0,0,0,0,0,0,0,0,0,0,0,0,0,0,0,9,0,0,0,0,0,0,9,0,0,0,0,0,0,0,0,0,0,0,0,0,0,0,0,0,0,0,0,0,0,0,0,0,9,9,9,9,0,0,9,9,9,9,9,9,9,9,9,9,0,0,0,0,0,0,0,0,0,0,0,0,0,9,0,0,0,0,0,0,0,0,0,0,0,0,0,0,0,0,0,0,0,0,0,0,0,0,0,9,0,0,0,9,0,0,0,9,0,0,0,9,0,0,9,0,9,0,0,0,0,0,0,0,0,9,0,0,0,9,0,0,9,0,9,0,0,9,0,0,9,0,9,0,0,0,0,0,0,0,0,9,0,0,0,9,0,0,9,0,9,0,0,9,0,0,9,0,9,0,0,0,0,0,0,0,0,9,0,0,0,9,0,0,9,0,9,0,0,9,0,0,9,0,9,0,0,0,0,0,0,0,0,9,0,0,0,9,0,0,9,0,9,0,0,9,0,0,9,9,9,0,0,0,0,0,0,0,0,0,0,0,0,0,0,0,0,0,0,0,0,0,0,0,0,0,0,0,0,0,0,0,0,0,0,0,0,0,0,0,0,0,0,0,0,0,0,0,0,0,0,0,0,0,0,9,9,9,9,9,9,0,0,0,0,0,0,0,0,0,0,0,0,0,0,0,9,9,9,9,9,0,0,0,0,0,9,0,0,0,0,0,0,0,0,0,0,0,0,0,0,9,9,0,0,0,0,0,0,0,0,0,9,0,0,0,0,0,0,0,0,0,0,0,0,0,0,9,0,0,0,0,0,0,0,0,0,0,9,0,0,0,0,0,0,0,0,0,0,0,0,0,0,9,0,0,0,0,0,0,0,0,9,9,9,0,0,0,0,0,9,9,9,9,0,0,0,0,0,9,9,9,9,0,0,0,0,0,0,0,0,0,0,0,0,0,9,13,0,9,0,0,0,0,0,0,0,0,0,0,0,0,0,0,0,0,0,0,0,0,0,0,9,0,0,9,0,0,0,0,0,0,0,0,0,0,0
0,0,0,0,0,0,0,0,0,0,0,0,0,0,0,0,0,0,0,0,0,0,0,0,0,0,0,0,0,0,0,0,0,0,0,0,0,0,0,0,0,0,0,0,0,0,0,0,0,0,0,0,0,0,8,8,0,0,8,8,0,0,8,8,0,0,8,8,0,0,8,8,0,0,8,8,0,0,0,0,8,8,0,0,8,8,0,0,8,8,0,0,8,8,0,0,8,8,0,0,8,8,0,0,0,0,8,8,0,0,8,8,0,0,8,8,0,0,8,8,0,0,8,8,0,0,8,8,0,0,0,0,8,8,0,0,8,8,0,0,8,8,9,9,8,8,0,0,8,8,0,0,8,8,0,0,0,0,8,8,0,0,8,8,0,0,8,8,9,9,8,8,0,0,8,8,0,0,8,8,0,0,0,0,8,8,0,0,8,8,0,0,8,8,0,0,8,8,0,0,8,8,0,0,8,8,0,0,0,0,8,8,0,0,8,8,0,0,0,0,0,0,0,0,0,0,8,8,0,0,8,8,0,0,0,0,8,8,0,0,8,8,0,0,0,0,0,0,0,0,0,0,8,8,0,0,8,8,0,0,0,0,0,0,0,0,0,0,0,0,8,8,11,0,8,8,0,0,0,0,0,0,0,0,0,0,0,0,0,0,0,0,0,0,0,0,8,8,0,0,8,8,0,0,0,0,0,0,0,0,0,0,8,8,0,0,8,8,8,8,0,0,0,0,0,0,0,0,0,0,8,8,8,8,0,0,8,8,9,9,0,0,8,8,8,8,0,0,0,0,0,0,0,0,0,0,8,8,8,8,0,0,9,9,0,0,0,0,0,0,0,0,0,0,8,8,0,0,8,8,0,0,0,0,0,0,0,0,0,0,0,0,0,0,0,0,0,0,0,0,8,8,8,8,8,8,0,0,0,0,0,0,0,0,0,0,0,0,8,8,0,0,8,8,0,0,8,8,8,8,8,8,0,0,8,8,0,0,8,8,0,0,0,0,8,8,0,0,8,8,0,0,8,8,0,0,8,8,0,0,8,8,0,0,8,8,0,0,0,0,8,8,0,0,8,8,0,0,8,8,0,0,8,8,0,0,8,8,0,0,8,8,0,0,0,0,8,8,0,0,8,8,0,0,8,8,0,0,8,8,0,0,8,8,0,0,8,8,10,0,10,0,8,8,0,0,8,8,0,0,8,8,0,0,8,8,0,0,8,8,0,0,8,8,0,0,0,0,8,8,0,0,8,8,0,0,0,0,0,0,0,0,0,0,8,8,0,0,8,8,10,0,10,0,8,8,0,0,8,8,0,0,0,0,0,0,0,0,0,0,8,8,0,0,8,8,0,0,0,0,8,8,0,0,8,8,0,0,0,9,9,9,9,0,0,0,8,8,0,0,8,8,0,0,0,0,10,0,0,0,10,0,0,0,0,9,13,0,9,0,0,0,10,0,0,0,10,0,0,0,0,0,0,0,0,0,0,0,0,0,0,9,0,0,9,0,0,0,0,0,0,0,0,0,0,0
0,0,0,0,0,8,0,0,8,0,0,0,0,0,0,0,0,0,0,8,8,8,0,0,0,0,0,0,0,0,8,8,0,0,8,0,0,0,0,0,0,0,0,0,8,8,0,8,0,0,0,0,0,0,0,8,8,0,0,0,8,8,0,0,0,0,0,0,0,0,8,0,0,8,0,0,0,0,8,8,8,8,0,0,0,0,0,8,8,8,8,8,8,8,8,8,8,0,0,0,8,8,8,8,0,0,0,0,0,0,0,0,0,0,0,0,0,0,0,0,0,0,0,0,0,0,0,0,0,0,0,0,0,0,0,0,0,0,0,0,0,0,0,0,0,0,0,0,0,0,0,0,0,0,0,0,9,0,9,9,0,9,9,0,9,9,0,9,9,0,9,9,0,9,9,0,9,9,0,9,9,0,11,11,11,11,11,11,11,11,11,11,11,11,11,11,11,11,11,11,11,11,11,11,11,11,0,11,0,0,0,0,0,0,0,0,0,0,0,0,0,0,0,0,0,0,11,9,9,9,9,11,11,11,9,0,9,9,0,9,9,0,9,9,0,9,9,0,9,9,0,9,9,0,9,9,0,9,9,0,0,0,0,0,0,0,0,0,0,0,0,0,0,0,0,0,0,0,0,0,0,0,0,0,0,0,0,0,0,0,0,0,0,0,0,0,0,0,0,0,0,0,0,0,0,0,0,0,0,0,0,0,0,0,0,8,8,8,8,0,0,0,8,0,0,8,8,0,0,0,0,0,0,0,0,0,0,0,0,0,0,8,0,0,8,0,0,0,8,8,8,8,0,0,0,0,0,0,8,0,0,0,0,0,0,0,8,8,0,0,0,0,0,0,8,8,0,0,0,0,0,0,0,0,8,8,8,8,8,8,0,0,8,0,0,0,0,0,0,0,8,8,8,8,8,8,0,0,0,0,8,8,0,0,0,8,0,0,8,0,0,0,0,0,0,0,8,0,0,0,0,0,0,0,0,0,8,0,0,0,0,8,0,8,8,0,0,0,0,0,0,0,0,0,0,0,0,0,0,0,0,0,8,0,0,0,0,8,0,0,8,8,0,8,8,0,0,8,0,0,0,0,0,0,8,0,0,0,8,0,0,0,0,8,0,0,0,8,8,8,0,0,0,0,8,0,0,0,0,8,0,0,0,0,8,0,0,0,0,8,0,0,0,0,0,0,0,0,0,0,0,8,0,0,8,0,0,0,0,0,0,0,0,0,0,0,0,0,0,0,0,0,0,0,0,0,0,0,8,8,0,0,0,0,0,0,0,0,0,0,0,0,0,0,0,0,0,0,0,0,0,0,0,0,8,8,0,0,0,0,0,0,0,0,0,0,0,0,0,0,0,0,0,0,0,0,0,0,0,9,9,9,9,0,0,0,0,0,0,0,0,0,0,0,0,0,0,0,0,0,0,0,12,12,12,9,13,0,9,12,12,0,0,0,0,0,0,0,0,0,0,0,0,0,0,0,0,0,12,12,12,9,0,0,9,0,0,0,0,0,0,0,0,0,0,0